91 23
20 0,20 2,13 2,13 4,6 4,6 7,9 7,9 9,13 9,13 7,20 7,20 11,10 11,10 14,4 14,4 17,8 17,8 18,16 18,16 17,20 17,20 15,25 15
00000000000000000000100000
00000000000000000000100000
00000000000001111111100000
00000000000001000000000000
00000011111111000000000000
00000010000000000000000000
00000010000000000000000000
00000011110001111111100000
00000000010001000000100000
00000000011111000000100000
00000000000000000000100000
00000000001111111111100000
00000000001000000000000000
00000000001000000000000000
00001111111000000000000000
00001000000000000000111111
00001000000000000000100000
00001111100000001111100000
00000000111111111000000000
00000000000000000000000000
