74 16
2 0,2 4,6 4,6 8,10 8,10 14,6 14,6 18,19 18,19 14,15 14,15 8,19 8,19 4,23 4,23 0
00100000000000000000000100
00100000000000000000000100
00100000000000000000000100
00100000000000000000000100
00111110000000000001111100
00000010000000000001000000
00000010000000000001000000
00000010000000000001000000
00000011111000011111000000
00000000001000010000000000
00000000001000010000000000
00000000001000010000000000
00000000001000010000000000
00000000001000010000000000
00000011111000011111000000
00000010000000000001000000
00000010000000000001000000
00000010000000000001000000
00000011111111111111000000
00000000000000000000000000