122 14
21 0,21 2,4 2,4 5,21 5,21 8,4 8,4 11,21 11,21 14,4 14,4 17,21 17,21 19
00000000000000000000010000
00000000000000000000010000
00001111111111111111110000
00001000000000000000000000
00001000000000000000000000
00001111111111111111110000
00000000000000000000010000
00000000000000000000010000
00001111111111111111110000
00001000000000000000000000
00001000000000000000000000
00001111111111111111110000
00000000000000000000010000
00000000000000000000010000
00001111111111111111110000
00001000000000000000000000
00001000000000000000000000
00001111111111111111110000
00000000000000000000010000
00000000000000000000010000