122 20
0 2,13 2,13 5,21 5,21 7,24 7,24 11,5 11,5 9,2 9,2 14,21 14,21 16,6 16,6 18,14 18,14 19,19 19,19 18,25 18
00000000000000000000000000
00000000000000000000000000
11111111111111000000000000
00000000000001000000000000
00000000000001000000000000
00000000000001111111110000
00000000000000000000010000
00000000000000000000011110
00000000000000000000000010
00111100000000000000000010
00100100000000000000000010
00100111111111111111111110
00100000000000000000000000
00100000000000000000000000
00111111111111111111110000
00000000000000000000010000
00000011111111111111110000
00000010000000000000000000
00000011111111100001111111
00000000000000111111000000