54 10
0 3,6 3,6 9,10 9,10 14,4 14,4 17,20 17,20 15,25 15
00000000000000000000000000
00000000000000000000000000
00000000000000000000000000
11111110000000000000000000
00000010000000000000000000
00000010000000000000000000
00000010000000000000000000
00000010000000000000000000
00000010000000000000000000
00000011111000000000000000
00000000001000000000000000
00000000001000000000000000
00000000001000000000000000
00000000001000000000000000
00001111111000000000000000
00001000000000000000111111
00001000000000000000100000
00001111111111111111100000
00000000000000000000000000
00000000000000000000000000